7 7
0 0 7 1 0
0 0 1 6 0
0 5 7 1 0
5 0 1 3 0
6 0 1 6 0
5 4 1 2 0
3 4 1 1 0
1 1 1 3 -1
2 1 1 3 1
3 1 2 1 1
3 2 1 2 1
4 3 2 1 -2
