################
#0#.....#......9
#.#.#####.######
#.......#.#.#..6
#.#####.#.#.#.##
#3#5#...........
###.###.#######.
#...#8..#...#1..
#.#####.###.####
#.......#.#...#.
#.#.#####.#.###.
#.#.#.#4#.......
#.###.#.#.#.####
#.........#.....
###.#.#####.#.##
#7..#.#.....#..2
